Thermal Monitor Shutdown=thermalmonitord|thermal pressure|thermal runaway|heat warning|shutdown|prochot asserted
Battery GasGauge Error=GasGauge|battery capacity|battery current error
Sensor Hub Crash=sensor hub crash|sensor controller crash|MotionCoproc|sensor panic
SMC Sensor Failure=SMC PANIC|sensor array|OUTBOX1 not ready|SMC BSC failure
Baseband Crash=Baseband crash|modem crash|modem reset|firmware panic
SEP Panic=SEP panic|sep crash|sep firmware panic|sepos error
BridgeOS Panic=BridgeOS|AppleBridgeDevice|BridgeOS error
Unexpected Reset=ResetCause|Unexpected reset
Low Memory=memory pressure|low memory
Killed Process=killed process
Filesystem Corruption=filesystem corruption|fs corruption
PCIe Error=PCIe error|IOPPFirmware panic
WiFi Chip Crash=awdl0 crash|WifiCore|IO80211
Bluetooth Crash=Bluetooth crash|BTChip
Camera Failure=camera error|IR projector error|TrueDepth sensor fail
NAND Controller Failure=nand controller fail|NAND panic
IO Report Panic=ioreport panic|IOService
Power Manager Watchdog=pmgr watchdog|Power Manager
Audio Codec Error=audio codec reset|HALB error|I2S error
Display Processor Error=DCP assertion failed|DisplayCoProcessor error
USB Error=usb device error|IOUSBHost crash
SIM Error=sim crash|sim lock|sim toolkit
GPS Module Error=locationd crash|GPS module error
Vibration Motor Error=taptic engine fail|haptic feedback error
Unexpected Shutdown=shutdown cause|panic shutdown
Jetsam Memory Pressure=jetsam event
Watchdog Timeout=watchdog timeout|no successful checkins
AOP NMI Panic=AOP NMI FIQ
DART CPUDART Error=DART\(CPUDART\) error|PTE invalid exception
Page Fault Error=page fault|translation fault|vm_fault
GPU Panic=AGXFirmware|GPU hang|GPU reset|GPU Panic
Spinlock Timeout=spinlock timeout|deadlock|mutex timeout
I2C Bus Error=i2c error|IOP panic|i2c bus hang
RTKit Panic=RTKit panic|RTBuddy|rtBuddy
BridgeOS Watchdog Reset=BridgeOS watchdog|BridgeOS reset
Thermal Throttling=thermal throttle|throttled due to high temperature
